################################################################################
#..............................................................................#
#..............................................................................#
#..............................................................................#
#..............................................................................#
#..............................................................................#
#..............................................................................#
#..............................................................................#
#..............................................................................#
#..............................................................................#
#...............................................................................
#...............................................................................
#..............................................................................#
#..............................................................................#
#..............................................................................#
#..............................................................................#
#..............................................................................#
#..............................................................................#
#..............................................................................#
#..............................................................................#
#..............................................................................#
#..............................................................................#
################################################################################