##################
#................#
#...##...###.....#
#...##...........#
#.............####
##################