................................####........
............................................
........#######................####.........
####.............####.......................
##..........................................
............................................
#.................................#####.....
####.............####.......................
##..........................................
............................................
#.................................#####.....