##################################################
#................................####............#
#..............#.................................#
#........#######................####.........#####
#####.............####.......................#####
###...............#..........................#####
#.......s........................................#
##.................................#####.........#
#####.............####...........................#
###..............................................#
#................................................#
##.................................#####.........#
#................................................#
######...........................................#
##################################################