######################################################################
#....................................................................#
#........##################################################..........#
#........##################################################..........#
#........##################################################..........#
#........##################################################..........#
#........##################################################..........#
#........##################################################..........#
#........##################################################..........#
#........##################################################..........#
#........##################################################..........#
#........##################################################..........#
#....................................................................#
#....................................................................#
#....................................................................#
#....................................................................#
#...............................s....................................#
#....................................................................#
#....................................................................#
#....................................................................#
#....................................................................#
#.........##############.............................................#
#.........##############.............................................#
#.........##############.............................................#
#.........##############.............................................#
#.........##############.............................................#
#.........##############.............................................#
#.........##############...................#####.....................#
#.........##############...................#####.....................#
#.........##############...................#####.....................#
#.........##############...................#####.....................#
#.........##############...................#####.....................#
#.........#################################################..........#
#.........#################################################..........#
#.........#################################################..........#
#.........#################################################..........#
#.........#################################################..........#
#.........#################################################..........#
#.........#################################################..........#
#.........#################################################..........#
#.........#################################################..........#
#.........#################################################..........#
#......................############################..................#
#......................############################..................#
#......................############################..................#
#......................############################..................#
#......................############################..................#
#......................############################..................#
#......................############################..................#
#......................############################..................#
#......................#################.............................#
#......................#################.............................#
#......................#################.............................#
#......................#################.............................#
#......................#################.............................#
#......................#################.............................#
#......................#################.............................#
#....................................................................#
#....................................................................#
#....................................................................#
#....................................................................#
#....................................................................#
#....................................................................#
#....................................................................#
#....................................................................#
#....................................................................#
#....................................................................#
#....................................................................#
#....................................................................#
######################################################################