###########################################
#.....................#............#......#
#.....................#............#......#
#.....................#............#......#
#.....................#............#......#
#.....................#............#......#
###..###################...##########..####
#.........................................#
#.........................................#
#.........................................#
#.........................................#
#......#################.................s#
#.........................................#
#.........................................#
#.........................................#
#.........................................#
###..###################...##########..####
#.....................#............#......#
#.....................#............#......#
#.....................#............#......#
#.....................#............#......#
#.....................#............#......#
###########################################