################################################################################
#..........#............#............#.....................#............#......#
#..........#............#............#.....................#............#......#
#..........#............#............#.....................#............#......#
#..........#............#............#.....................#............#......#
#..........#............#............#.....................#............#......#
#.....##..###...##########..############..###################...##########..####
#######........................................................................#
#.....#........................................................................#
#..............................................................................#
#.....#........................................................................#
#######...........#########..#############..#################.................s#
#.....#........................................................................#
#..............................................................................#
#.....#........................................................................#
#######........................................................................#
#.....##..###...##########..############..###################...##########..####
#..........#............#............#.....................#............#......#
#..........#............#............#.....................#............#......#
#..........#............#............#.....................#............#......#
#..........#............#............#.....................#............#......#
#..........#............#............#.....................#............#......#
################################################################################