#####################################
#...................................#
#...................................#
#...................................#
#...................................#
#..s................................#
#...................................#
#...................................#
#...................................#
#####################################