##############################################
#................................####........#
#............................................#
#........#######................####.........#
#####.............####.......................#
###..........................................#
#.......s....................................#
##.................................#####.....#
#####.............####.......................#
###..........................................#
#............................................#
##.................................#####.....#
##############################################