##############################
#............................#
#..s.........................#
#............................#
#............................#
#............................#
#............................#
##############################