##################
#................#
#...##...###.....#
#...##...........#
#......s......####
##################