##############################
#..s.........................#
#............................#
#............................#
#............................#
#............................#
#............................#
##############################