##################
#................#
#......s.........#
#................#
#................#
##################