################################################################################
#..............................................................................#
#..............................................................................#
#..............................................................................#
#..............................................................................#
#..........##....................##################################............#
#..........##....................##################################............#
#..........##..................................................................#
#..........##..................................................................#
#..........##..................................................................#
#..........##..................................................................#
#..........##.................................................................s#
#..........##..................................................................#
#..........##..................................................................#
#..........##..................................................................#
#..........##....................##################################............#
#..........##....................##################################............#
#..............................................................................#
#..............................................................................#
#..............................................................................#
#..............................................................................#
#..............................................................................#
################################################################################